1 13 31
###############################
#p     ** *  1 * 2 *  * * *   #
# # # #*# # #*#*# # # #*#*#*# #
#  x*     ***  *  4   * 5 * * #
# # # # # #*# # #*#*# # # # #*#
#f         x **  *  *   3     #
# # # # # # # # # #*# #*# # # #
#*  *   s  *  *      *        #
# # # # #*# # # #*#*# # # # # #
#*    **  *      *            #
# #*# # # # # # #*# # # # # # #
#  b        *   *  *          #
###############################